{
	"stages": [
		{
			"number":1,
			"stage":[
				0,0,0,0,0,0,0,0,0,0,0,0,0,
				0,0,0,0,0,0,0,0,0,0,0,0,0,
				0,0,0,0,0,0,0,0,0,0,0,0,0,
				5,5,5,5,5,5,5,5,5,5,5,5,5,
				1,1,1,1,1,1,1,1,1,1,1,1,1,
				2,2,2,2,2,2,2,2,2,2,2,2,2,
				3,3,3,3,3,3,3,3,3,3,3,3,3,
				4,4,4,4,4,4,4,4,4,4,4,4,4,
				0,0,0,0,0,0,0,0,0,0,0,0,0,
				0,0,0,0,0,0,0,0,0,0,0,0,0,
				0,0,0,0,0,0,0,0,0,0,0,0,0,
				0,0,0,0,0,0,0,0,0,0,0,0,0,
				0,0,0,0,0,0,0,0,0,0,0,0,0,
				0,0,0,0,0,0,0,0,0,0,0,0,0,
				0,0,0,0,0,0,0,0,0,0,0,0,0,
				0,0,0,0,0,0,0,0,0,0,0,0,0,
				0,0,0,0,0,0,0,0,0,0,0,0,0,
				0,0,0,0,0,0,0,0,0,0,0,0,0,
				0,0,0,0,0,0,0,0,0,0,0,0,0,
				0,0,0,0,0,0,0,0,0,0,0,0,0,
				0,0,0,0,0,0,0,0,0,0,0,0,0,
				0,0,0,0,0,0,0,0,0,0,0,0,0
			]
		},
		{
			"number":2,
			"stage":[
				0,0,0,0,0,0,0,0,0,0,0,0,0,
				0,0,0,0,0,0,0,0,0,0,0,0,0,
				1,0,0,0,0,0,0,0,0,0,0,0,0,
				1,2,0,0,0,0,0,0,0,0,0,0,0,
				1,2,3,0,0,0,0,0,0,0,0,0,0,
				1,2,3,4,0,0,0,0,0,0,0,0,0,
				1,2,3,4,3,0,0,0,0,0,0,0,0,
				1,2,3,4,3,2,0,0,0,0,0,0,0,
				1,2,3,4,3,2,1,0,0,0,0,0,0,
				1,2,3,4,3,2,1,4,0,0,0,0,0,
				1,2,3,4,3,2,1,4,3,0,0,0,0,
				1,2,3,4,3,2,1,4,3,2,0,0,0,
				1,2,3,4,3,2,1,4,3,2,1,0,0,
				1,2,3,4,3,2,1,4,3,2,1,4,0,
				5,5,5,5,5,5,5,5,5,5,5,5,4,
				0,0,0,0,0,0,0,0,0,0,0,0,0,
				0,0,0,0,0,0,0,0,0,0,0,0,0,
				0,0,0,0,0,0,0,0,0,0,0,0,0,
				0,0,0,0,0,0,0,0,0,0,0,0,0,
				0,0,0,0,0,0,0,0,0,0,0,0,0,
				0,0,0,0,0,0,0,0,0,0,0,0,0,
				0,0,0,0,0,0,0,0,0,0,0,0,0
			]
		},
		{
			"number":3,
			"stage":[
				0,9,0,0,0,0,0,0,0,0,0,0,0,
				0,0,0,0,0,0,0,0,0,0,0,0,0,
				0,9,0,0,0,0,0,0,0,0,0,0,0,
				0,9,0,0,0,0,0,0,0,0,0,0,0,
				0,9,0,0,0,0,0,0,0,0,0,0,0,
				0,9,0,0,0,0,0,0,0,0,0,0,0,
				0,9,0,0,0,0,0,4,0,0,0,0,0,
				0,9,0,0,0,0,4,3,4,0,0,0,0,
				0,9,0,0,0,4,3,2,3,4,0,0,0,
				0,9,0,0,4,3,2,1,2,3,4,0,0,
				0,9,0,4,3,2,1,2,1,2,3,4,0,
				0,9,0,0,4,3,2,1,2,3,4,0,0,
				0,9,0,0,0,4,3,2,3,4,0,0,0,
				0,9,0,0,0,0,4,3,4,0,0,0,0,
				0,9,0,0,0,0,0,4,0,0,0,0,0,
				0,9,0,0,0,0,0,0,0,0,0,0,0,
				0,9,0,0,0,0,0,0,0,0,0,0,0,
				0,9,9,9,9,9,9,9,9,9,9,9,9,
				0,0,0,0,0,0,0,0,0,0,0,0,0,
				0,0,0,0,0,0,0,0,0,0,0,0,0,
				0,0,0,0,0,0,0,0,0,0,0,0,0,
				0,0,0,0,0,0,0,0,0,0,0,0,0
			]
		}	
	]
}
